Class Name	BEL Encoding
?	A
anatomy	A
antibody	A
aptamer	A
biological process	B
cellular component	A
chemical	A
chemical (proprietary)	A
chemical class	A
chemical mixture	A
chemical role	A
clinical measurement	A
domain	P
enzyme class	P
epitope	P
exposure	O
genetic variant	G
isoform	PR
molecular function	Y
motif	P
pathology	O
pathway	B
peptide	AP
post-translational modification	T
protein	PRG
protein complex	C
protein family	P
protein fragment	P
protein isoform family	P
protein variant	P
